10 20
####################
#S #              #
# # ############# #
#                 #
################ ##
#                 #
# ################
#             #  E#
# ###############
####################